3
0 4 0 5 13 4
4 8 5 25 13 4
8 12 5 25 13 4
12
64 32 544 32 2 1 1 0
544 32 544 448 2 1 1 90
544 448 64 448 2 1 1 0
64 448 64 32 2 1 1 90
96 384 128 384 2 1 1 0
128 384 128 416 2 1 1 90
128 416 96 416 2 1 1 0
96 416 96 384 2 1 1 90
480 384 512 384 2 1 1 0
512 384 512 416 2 1 1 90
512 416 480 416 2 1 1 0
480 416 480 384 2 1 1 90

288 48 118 0 0